11111111111111111
00001000100000001
10101110101011111
10100010101010001
10111010101110101
10001010101000101
10101010101011101
10101000101010001
11101111101011111
10001000100000101
10111010111010101
10000010001010101
11111011101110101
10001000100000101
10111110111111101
10100010000000001
10101011111111101
10001000001000101
11111111101010101
10000000101010101
10111110101010101
10000010100010101
10111010101111101
10100010001010001
10111011111010111
10001000100010001
11101110101011101
10001000001000101
10111011111110101
10001000000010000
11111111111111111